11111111111111111111111
10P00010000000000100001
1000001000000000000E001
10000000000C00000111111
10000010000000000000001
10000010000000000000001
1000C00000C000000000001
11111111111111111111111
