11111111111111111111111
100000000C000000C000001
10000000111000000000001
10P01000000001111111111
1000101C000000000000001
10000010000001000E00001
10001010000001000000001
11111111111111111111111
